101/2/P/N
102/4/P/N
103/4/S/N
201/2/S/Y
202/4/L/N